W , W , W , W , W , W , W , W , W , W , W , W , W , W , W , W , W , W , W , W
W ,   ,   ,   ,   , W ,   ,   ,   ,   ,   ,   ,   ,   ,   ,   ,   ,   ,   , W
W ,   ,   ,   ,   ,   ,   ,   ,   ,   ,   ,   ,   ,   ,   ,   ,   ,   ,   , W
1 ,   , W ,   ,   ,   ,   ,   , B ,   ,   ,   ,   ,   ,   ,   ,   ,   ,   , W
W ,   ,   ,   ,   , F ,   ,   ,   ,   ,   ,   ,   ,   ,   ,   ,   ,   ,   , W
W ,   ,   ,   ,   ,   ,   ,   ,   ,   ,   ,   ,   ,   ,   ,   ,   ,   ,   , W
W ,   ,   ,   ,   ,   ,   , M ,   ,   ,   ,   ,   ,   , K2,   ,   ,   ,   , W
W ,   , P ,   ,   ,   ,   , M ,   ,   ,   ,   ,   ,   ,   ,   ,   ,   ,   , W
W ,   ,   ,   ,   ,   ,   , M ,   ,   ,   ,   ,   ,   ,   ,   ,   ,   ,   , W
W , W , W , W , W , W , 1 , W , W , W , W , W , W , W , W , W , W , W , W , W