W , W , W , W , W , W , W , W , W , W , W , W , W , W , W , W , W , W , W , W
W ,   ,   ,   ,   , W ,   ,   ,   ,   ,   ,   ,   ,   ,   ,   ,   ,   ,   , W
W ,   ,   ,   ,   ,   ,   ,   ,   ,   ,   ,   ,   ,   ,   ,   ,   ,   ,   , W
W ,   , W ,   ,   ,   ,   ,   ,   ,   ,   ,   ,   ,   ,   ,   ,   ,   ,   , W
W ,   ,   ,   ,   ,   ,   ,   ,   ,   ,   ,   ,   ,   ,   ,   ,   ,   ,   , W
W ,   ,   ,   ,   ,   ,   ,   ,   ,   ,   ,   ,   ,   ,   ,   ,   ,   ,   , W
W ,   ,   ,   ,   ,   ,   ,   ,   ,   ,   ,   ,   ,   , K2,   ,   ,   ,   , W
W ,   , P ,   ,   ,   ,   ,   ,   ,   ,   ,   ,   ,   ,   ,   ,   ,   ,   , W
W ,   ,   ,   ,   ,   ,   ,   ,   ,   ,   ,   ,   ,   ,   ,   ,   ,   ,   , W
W , W , W , W , W , W , W , W , W , W , W , W , W , W , W , W , W , W , 1 , W